using ll=long long;
using pii=pair<int, int>;
using pllll=pair<long long, long long>;
using pci=pair<char, int>;
using pipii=pair<int, pair<int, int>>;
using ppiii=pair<pair<int, int>, int>;
using vi=vector<int>;
using vll=vector<long long>;
using vd=vector<double>;
using vb=vector<bool>;
using vc=vector<char>;
using vstr=vector<string>;
using vpii=vector<pair<int, int>>;
using vpllll=vector<pair<long long, long long>>;
using vpci=vector<pair<char, int>>;
using vpipii=vector<pair<int, pair<int, int>>>;
using vppiii=vector<pair<pair<int, int>, int>>;
using vvi=vector<vector<int>>;
using vvll=vector<vector<long long>>;
using vvb=vector<vector<bool>>;
using vvc=vector<vector<char>>;
using vvpii=vector<vector<pair<int, int>>>;
using vvvi=vector<vector<vector<int>>>;
using vvvll=vector<vector<vector<long long>>>;
using dqi=deque<int>;
using dqll=deque<long long>;
using dqpii=deque<pair<int, int>>;
using pqi=priority_queue<int>;
using pqig=priority_queue<int, vector<int>, greater<int>>;
using pqll=priority_queue<long long>;
using pqllg=priority_queue<long long, vector<long long>, greater<long long>>;
using mii=map<int, int>;
using umii=unordered_map<int, int>;

using vvvb=vector<vector<vector<bool>>>;
using vvvvb=vector<vector<vector<vector<bool>>>>;
using vvvvi=vector<vector<vector<vector<int>>>>;
using vvstr=vector<vector<string>>;
using vpvii=vector<pair<vector<int>, int>>;
using tiiii=tuple<int, int, int, int>;
using dqtiiii=deque<tuple<int, int, int, int>>;
using si=set<int>;
using sc=set<char>;