character = char = ch
string = str

vector = vec (= v)
stack = stk = st
queue = que (= q)
priority queue = pq
deque = dq

list = lst

solution = sol
answer = ans
result = res
return = ret

temp = tmp

previous = prev = prv
current = cur
next = nxt

coordinate = coord
value = val
position = pos
count = cnt
frequency = freq = frq
index = idx
adjacency matrix = adj_mat = adj
factorial = fact
level = lv
INFinity = INF
compare = cmp
pointer = ptr
iterator = iter = it
degree = deg

discovery (time) = dsc
DFS Number = dfn
low = lowlink

Longest Increasing Subsequence = LIS
Directed Acyclic Graph = DAG

Lowest Common Ancestor = LCA

Strongly Connected Component = SCC

snippet

length = len
height
width
depth

Binary Indexed Tree = BIT

error = err

constructor = ctor
destructor = dtor

left hand side = lhs
right hand side = rhs

check = chk